{
  "Level_info": {
  "name": "level 1"},
  "map":[
    "##############################################################################################################################.............................########",
    "##############################################################################################################################.............................########",
    "##############################################################################################################################.............................########",
    "##############################################################################################################################.............................########",
    "##############################################################################################################################..$...........................#######",
    "##############################################################################################################################pppppppppppppp....................<##",
    "#############################################################################################################################..............................pppppppp",
    "#####################################################################################################################.........................!.....^*^...?.#######",
    "###......................###.......###.......###............###........###..........................!###############......................ppppppppppppppppppppppppp",
    "###......................###.......###.......###............###........###...........................##############.................*......########################",
    "###......................###.......###.......###............###........###....................===....#############.................pppp....########################",
    "###......................^^^.......^^^.......^^^............^^^........###...........................############..........................########################",
    "###....................................................................###..........................p###########!.........................p########################",
    "###....................................................................^^^...........................##########............................########################",
    "###.......................*...^.^...*...^.^...*........^.^...*.......................................-.....s...*.................e.........########################",
    "###..................ppppppppppppppppppppppppppppppppppppppppppppp.............*.ppppppppppppppppppppppppppppppppppppppppppppppppppppppppppppp#####################",
    "###>@................#...........................................#..^^...*....pppp#################################################################################",
    "###pppppppppppppppppppppppppppppppppppppppppppppppppppppppppppppppppppppppppppp####################################################################################",
    "###################################################################################################################################################################"
  ],
  "entities": {
    "player": [{"health":  100}]
  }
}